1111111111111111111111111
1040100010001000000010001
1110151110101011101011101
1000101000100010101000001
1011101011111110101111101
1010000000100010100000101
1011111110101010111110101
1000000010001010001000101
1111111011111010101011101
1000100010001010101010001
1110101110111010101011111
1000100010000000101000001
1011111010111111111111101
1000001010000010001000001
1011101011111110101011101
1000100000000000100010001
1111111111111111111111111